EA ./textures/wall4.png
SO ./textures/wall2.png
WE ./textures/wall3.png   
NO ./textures/wall1.png

C 135,206,250
F 100,140,60  
                                       111111                                        
                                       1100011111111
11111111111111111                      1100000000001           
100000000000000011111111111111111111111111000000000011111111111
10000001000001000000000000000000000000000E000000000000000000001
100000010000010000000000000000000000000000000001111000000000001
100000010000000000000000010000000000000001111100001110111100001
100000000000000000000000010000000000000000000100000000100000001
111100111111100001111111111111111111100011100000000001111111001
100000000000000000000000010000000000000000000100000000100000001
111111111111111001111101111111101011111110011111111111000011111
100000000000000000000000010000000000000000000100000000100000001
111111111111111111111111111111111111111111111111111111111111111